{
    "row":9,
    "col":9,
    "moveNum":40,
    "clearNum" : [	21	,	21	,	0	,	21	,	0	,	20	,	20	,	45	]	,
    "clearNumIndex" : [0,1,3,5,6,7],
    "cells":[
1	,	1	,	1	,	1	,	1	,	1	,	1	,	1	,	1	,
1	,	1	,	2	,	2	,	2	,	2	,	2	,	1	,	1	,
1	,	2	,	2	,	2	,	2	,	2	,	2	,	2	,	1	,
1	,	2	,	2	,	2	,	2	,	2	,	2	,	2	,	1	,
1	,	2	,	2	,	2	,	2	,	2	,	2	,	2	,	1	,
1	,	2	,	2	,	2	,	2	,	2	,	2	,	2	,	1	,
1	,	2	,	2	,	2	,	2	,	2	,	2	,	2	,	1	,
1	,	1	,	2	,	2	,	2	,	2	,	2	,	1	,	1	,
1	,	1	,	1	,	1	,	1	,	1	,	1	,	1	,	1	

             ],
    "blocks":[
2	,	2	,	1	,	2	,	4	,	2	,	1	,	1	,	4	,
3	,	4	,	4	,	3	,	1	,	3	,	0	,	3	,	4	,
0	,	1	,	2	,	3	,	2	,	0	,	2	,	3	,	1	,
3	,	0	,	0	,	2	,	-1	,	3	,	1	,	1	,	4	,
-1	,	-1	,	-1	,	-1	,	-1	,	-1	,	-1	,	-1	,	-1	,
-1	,	-1	,	-1	,	-1	,	-1	,	-1	,	-1	,	-1	,	-1	,
-1	,	4	,	0	,	3	,	4	,	2	,	1	,	0	,	-1	,
-1	,	4	,	0	,	3	,	4	,	2	,	1	,	0	,	-1	,
-1	,	-1	,	-1	,	-1	,	-1	,	-1	,	-1	,	-1	,	-1	

             ],
    "blockTypes":[
1	,	1	,	1	,	1	,	1	,	1	,	1	,	1	,	1	,
1	,	1	,	1	,	1	,	1	,	1	,	1	,	1	,	1	,
1	,	1	,	1	,	1	,	1	,	1	,	1	,	1	,	1	,
1	,	1	,	1	,	1	,	-1	,	1	,	1	,	1	,	1	,
-1	,	-1	,	-1	,	-1	,	-1	,	-1	,	-1	,	-1	,	-1	,
-2	,	-1	,	-1	,	-1	,	-1	,	-1	,	-1	,	-1	,	-2	,
-2	,	1	,	1	,	1	,	1	,	1	,	1	,	1	,	-2	,
-2	,	1	,	1	,	1	,	1	,	1	,	1	,	1	,	-2	,
-2	,	-2	,	-2	,	-1	,	-1	,	-1	,	-2	,	-2	,	-2	

             ]
}