{
    "row":9,
    "col":9,
    "moveNum":30,
    "clearNum" : [	30	,	30	,	0	,	30	,	0	,	0	,	0	,	50	]	,
    "clearNumIndex" : [0,1,3,7,-1,-1],
    "cells":[
1	,	1	,	1	,	1	,	1	,	1	,	1	,	1	,	1	,
1	,	2	,	2	,	2	,	2	,	2	,	2	,	2	,	1	,
1	,	2	,	2	,	2	,	2	,	2	,	2	,	2	,	1	,
1	,	2	,	2	,	2	,	2	,	2	,	2	,	2	,	1	,
1	,	2	,	2	,	2	,	2	,	2	,	2	,	2	,	1	,
1	,	2	,	2	,	2	,	2	,	2	,	2	,	2	,	1	,
1	,	2	,	2	,	2	,	2	,	2	,	2	,	2	,	1	,
1	,	2	,	2	,	2	,	2	,	2	,	2	,	2	,	1	,
1	,	1	,	1	,	1	,	2	,	1	,	1	,	1	,	1	

             ],
    "blocks":[
2	,	4	,	0	,	4	,	4	,	0	,	0	,	2	,	3	,
1	,	3	,	4	,	3	,	1	,	2	,	3	,	1	,	4	,
0	,	1	,	0	,	4	,	0	,	4	,	1	,	2	,	2	,
2	,	4	,	3	,	3	,	4	,	2	,	4	,	3	,	4	,
1	,	0	,	1	,	0	,	2	,	1	,	1	,	0	,	1	,
3	,	3	,	4	,	1	,	0	,	3	,	4	,	2	,	3	,
0	,	2	,	2	,	1	,	0	,	3	,	2	,	4	,	4	,
1	,	3	,	4	,	3	,	1	,	2	,	3	,	1	,	4	,
0	,	1	,	0	,	4	,	0	,	4	,	1	,	2	,	2	

             ],
    "blockTypes":[
1	,	1	,	1	,	1	,	1	,	1	,	1	,	1	,	1	,
1	,	1	,	1	,	1	,	1	,	1	,	1	,	1	,	1	,
1	,	1	,	1	,	1	,	1	,	1	,	1	,	1	,	1	,
1	,	1	,	1	,	1	,	1	,	1	,	1	,	1	,	1	,
1	,	1	,	1	,	1	,	1	,	1	,	1	,	1	,	1	,
1	,	1	,	1	,	1	,	1	,	1	,	1	,	1	,	1	,
1	,	1	,	1	,	1	,	1	,	1	,	1	,	1	,	1	,
1	,	1	,	1	,	1	,	1	,	1	,	1	,	1	,	1	,
1	,	1	,	1	,	1	,	1	,	1	,	1	,	1	,	1	

             ]
}