{
    "row":9,
    "col":9,
    "moveNum":40,
    "clearNum" : [	0	,	0	,	25	,	20	,	0	,	0	,	30	,	20	]	,
    "clearNumIndex" : [2,3,6,7,-1,-1],
    "cells":[
1	,	2	,	2	,	2	,	2	,	2	,	1	,	1	,	1	,
2	,	2	,	2	,	2	,	2	,	1	,	1	,	1	,	1	,
2	,	2	,	2	,	2	,	1	,	1	,	1	,	1	,	1	,
2	,	2	,	2	,	1	,	1	,	1	,	1	,	1	,	1	,
2	,	2	,	1	,	1	,	1	,	1	,	1	,	1	,	1	,
2	,	1	,	1	,	1	,	1	,	1	,	1	,	1	,	1	,
1	,	1	,	1	,	1	,	1	,	1	,	1	,	1	,	1	,
1	,	1	,	1	,	1	,	1	,	1	,	1	,	1	,	1	,
1	,	1	,	1	,	1	,	1	,	1	,	1	,	1	,	1	

             ],
    "blocks":[
4	,	2	,	2	,	3	,	0	,	3	,	3	,	1	,	2	,
0	,	3	,	2	,	4	,	1	,	4	,	0	,	1	,	4	,
3	,	0	,	1	,	0	,	4	,	0	,	0	,	3	,	0	,
2	,	4	,	3	,	1	,	2	,	1	,	3	,	2	,	3	,
1	,	4	,	4	,	2	,	0	,	2	,	2	,	3	,	-1	,
2	,	1	,	0	,	1	,	4	,	0	,	3	,	-1	,	-1	,
4	,	0	,	2	,	0	,	4	,	3	,	-1	,	-1	,	-1	,
1	,	4	,	2	,	4	,	3	,	-1	,	-1	,	-1	,	-1	,
2	,	1	,	1	,	3	,	-1	,	-1	,	-1	,	-1	,	-1	

             ],
    "blockTypes":[
1	,	1	,	1	,	1	,	1	,	1	,	1	,	1	,	1	,
1	,	1	,	1	,	1	,	1	,	1	,	1	,	1	,	1	,
1	,	1	,	1	,	1	,	1	,	1	,	1	,	1	,	1	,
1	,	1	,	1	,	1	,	1	,	1	,	1	,	1	,	1	,
1	,	1	,	1	,	1	,	1	,	1	,	1	,	1	,	-2	,
1	,	1	,	1	,	1	,	1	,	1	,	1	,	-2	,	-2	,
1	,	1	,	1	,	1	,	1	,	1	,	-2	,	-2	,	-2	,
1	,	1	,	1	,	1	,	1	,	-2	,	-2	,	-2	,	-2	,
1	,	1	,	1	,	1	,	-2	,	-2	,	-2	,	-2	,	-2	

             ]
}